134111111111111111111
155555555555555512221
111111111111111511121
122222155555221555121
121211151115111115121
121215551215555555121
121115111211111111121
155555122555551222221
151111111511151111121
155515551515551555551
111515151515111511151
121555151515155512151
121111151515151112151
122222155515151222151
121112111115151211151
122212222215151555151
111212111115151515151
122212155555151515551
121112151111151511111
122212255555551555551
111111111111111111111
---
length=265
time=335
